1 1 1 1 1 1 1 1 1 1 1 1 1 1 1 1 1 1 1 1 1 1 1 1 1
1 4 0 0 0 0 0 0 0 0 0 8 0 0 10 0 0 8 0 0 0 0 0 0 1
1 4 10 0 0 8 0 0 0 0 0 1 1 1 4 1 1 1 0 0 0 0 0 0 1
1 1 1 1 1 1 1 1 4 0 0 0 0 0 4 0 0 0 0 0 0 10 0 8 1
1 0 0 0 0 0 0 0 4 0 0 0 0 0 4 0 0 0 0 4 1 1 1 1 1
1 0 0 0 0 0 0 0 4 0 8 0 0 0 4 0 0 0 0 4 0 0 0 0 1
1 0 0 0 0 4 1 1 1 2 2 2 1 1 1 4 0 0 0 4 0 0 0 0 1
1 8 0 0 0 4 0 0 0 0 0 0 0 0 0 4 0 0 0 4 0 0 0 0 1
1 1 1 1 1 4 0 0 0 0 3 3 3 3 3 4 0 0 8 4 0 0 0 8 1
1 0 0 0 0 4 0 0 0 0 0 0 0 0 0 4 1 1 1 1 1 1 1 1 1
1 0 0 0 0 4 1 1 1 1 1 0 0 0 0 4 0 0 0 0 0 0 0 0 1
1 0 0 0 0 4 0 0 0 0 0 0 7 0 0 4 0 0 0 0 0 0 0 0 1
1 1 1 1 1 1 1 1 1 1 1 1 1 1 1 1 1 1 1 1 1 1 1 1 1