1 1 1 1 1 1 1 1 1 1 1 1 1 1 1 1 1 1 1 1 1 1 1 1 1
1 4 0 0 0 0 0 0 0 0 0 0 0 0 0 0 0 0 0 0 0 0 4 0 1
1 4 0 0 0 0 0 0 8 0 0 0 0 10 0 0 0 0 0 8 0 0 4 0 1
1 4 0 0 0 0 1 1 1 1 1 1 1 1 1 4 1 1 1 1 1 1 4 0 1
1 4 0 0 0 8 0 0 0 0 0 0 0 0 0 4 0 0 0 0 0 0 4 0 1
1 4 8 0 10 0 0 0 0 0 0 0 0 0 0 4 0 8 0 0 10 8 4 0 1
1 1 1 1 1 1 1 4 3 3 3 3 3 3 3 4 1 1 1 1 4 2 2 2 1
1 1 1 1 1 1 1 4 0 0 0 0 0 0 0 0 0 0 0 0 4 0 0 0 1
1 1 1 1 1 0 0 4 0 0 0 0 0 8 0 0 0 0 0 0 4 0 0 8 1
1 1 1 1 1 0 0 4 0 0 4 1 1 1 1 1 4 0 0 0 4 1 1 1 1
1 0 0 0 0 0 0 4 0 0 4 0 0 0 0 0 4 0 0 0 4 0 0 0 1
1 0 0 0 0 0 0 4 0 0 4 0 7 0 0 0 4 0 0 0 4 0 0 0 1
1 1 1 1 1 1 1 1 1 1 1 1 1 1 1 1 1 1 1 1 1 1 1 1 1