1 1 1 1 1 1 1 1 1 1 1 1 1 1 1 1 1 1 1 1 1 1 1 1 1
1 4 0 10 0 4 0 0 0 0 0 0 0 0 0 0 0 0 0 4 0 0 0 0 1
1 4 1 2 2 4 3 3 3 3 3 3 3 3 3 3 3 3 3 4 2 2 1 2 1
1 4 0 0 2 4 0 0 0 0 8 0 0 0 8 0 0 0 0 4 2 0 0 2 1
1 4 0 0 0 4 0 8 0 0 0 10 0 0 0 0 0 8 0 4 0 0 0 0 1
1 2 1 1 2 4 1 1 1 1 1 1 1 1 1 1 1 1 1 4 2 1 1 2 1
1 2 1 1 2 4 0 0 0 0 0 0 0 10 0 0 0 0 0 4 2 1 1 2 1
1 2 0 0 2 4 0 0 0 4 1 2 2 2 1 4 0 0 0 4 2 0 0 2 1
1 2 1 1 2 4 1 1 1 4 1 0 2 0 1 4 1 1 1 4 2 1 1 2 1
1 0 0 0 0 4 0 0 0 4 1 2 2 2 1 4 0 0 0 4 0 0 0 0 1
1 8 0 0 0 4 0 0 0 4 0 0 7 0 0 4 0 0 0 4 0 0 0 8 1
1 1 1 1 1 1 1 1 1 1 1 1 1 1 1 1 1 1 1 1 1 1 1 1 1