1 1 1 1 1 1 1 1 1 1 1 1 1 1 1 1 1 1 1 1 1 1 1 1 1
1 4 0 0 0 8 0 0 8 0 0 0 4 0 0 0 8 0 0 8 0 0 0 4 1
1 4 1 1 1 1 1 1 1 1 1 1 4 1 1 1 1 1 1 1 1 1 1 4 1
1 4 8 0 0 0 0 0 10 0 0 8 4 8 0 0 0 0 0 0 0 0 8 4 1
1 4 1 1 1 1 1 1 1 1 1 1 4 1 1 1 1 1 1 1 1 1 1 4 1
1 4 0 0 0 8 0 0 8 0 0 0 4 0 0 0 8 0 0 8 0 0 0 4 1
1 4 1 1 1 1 1 1 1 1 1 1 4 1 1 1 1 1 1 1 1 1 1 4 1
1 4 8 0 0 0 0 0 0 0 0 8 4 8 0 0 0 0 0 0 0 0 8 4 1
1 4 1 1 1 1 1 1 1 1 1 1 2 1 1 1 1 1 1 1 1 1 1 4 1
1 4 1 1 1 1 1 1 1 1 1 1 2 1 1 1 1 1 1 1 1 1 1 4 1
1 4 1 1 1 1 1 1 1 1 1 1 2 1 1 1 1 1 1 1 1 1 1 4 1
1 4 8 0 10 0 0 0 0 0 0 0 7 8 0 0 0 0 0 0 10 0 8 4 1
1 1 1 1 1 1 1 1 1 1 1 1 1 1 1 1 1 1 1 1 1 1 1 1 1